20 15 0 0
0 0 1 1 1 1 1 1 1 1 1 1 1 1 1 1 1 1 1 1
0 0 1 1 1 1 0 0 0 0 0 0 0 0 1 1 1 1 1 1
0 0 0 0 F 1 0 0 0 0 0 0 0 0 1 1 1 1 1 1
0 0 1 0 0 1 0 0 0 0 0 0 0 0 1 1 1 1 1 1
F F 1 1 F 0 1 1 1 1 1 1 1 1 1 1 1 1 1 1
0 0 0 1 1 0 0 0 0 F 0 0 0 1 1 1 1 1 1 1
F F F 1 1 1 0 0 0 1 1 T 0 1 1 1 1 1 1 1
T T T 1 1 1 0 0 1 T 1 0 0 1 1 1 1 1 1 1
F F F 1 1 1 0 0 0 0 1 0 0 1 1 1 1 1 1 1
F F F 1 1 1 0 T 0 0 1 F 0 1 1 1 1 1 1 1
0 0 0 0 1 0 0 0 0 0 T 0 0 0 1 1 1 1 1 1
0 F 0 T 1 F 0 0 F 0 0 0 T 0 1 1 1 1 1 1
0 0 0 0 1 1 1 1 1 1 1 1 0 0 1 1 1 1 1 1
0 T 0 0 0 0 0 F 0 0 0 0 0 F 1 1 1 1 1 1
1 1 1 1 1 1 1 1 1 1 1 1 1 0 0 0 0 0 0 E
D 01001001 01000101