20 15 0 0
0 0 1 1 1 1 1 1 1 E 1 1 1 1 1 1 1 0 0 0
1 0 1 0 0 0 F 0 1 F 1 0 0 0 0 T 1 0 0 0
1 0 1 0 T 0 1 0 1 0 1 0 0 T 0 1 1 0 0 0
1 F 1 0 0 0 1 0 1 0 F 0 F 0 0 1 0 0 0 0
1 0 1 1 T T 1 T 1 T F 0 0 0 0 1 1 0 0 0
1 0 1 1 0 0 1 0 1 0 1 1 0 0 0 T 1 1 0 0
1 0 1 1 F F 1 0 1 0 0 0 F F F 0 0 1 1 0
1 T 1 1 0 0 1 0 0 0 0 T F T F 0 0 0 1 1
1 0 1 1 1 0 1 1 1 T 0 0 0 F 1 0 0 0 T 1
1 0 1 1 0 0 F 0 0 0 0 0 0 0 0 0 0 0 0 1
1 0 0 0 0 1 1 1 1 1 1 1 1 1 1 1 1 1 1 1
1 0 0 0 1 1 0 0 0 0 0 0 0 0 0 0 0 0 0 0
1 0 T 0 1 0 0 0 0 0 0 0 0 0 0 0 0 0 0 0
1 0 0 0 1 0 0 0 0 0 0 0 0 0 0 0 0 0 0 0
1 1 1 1 1 0 0 0 0 0 0 0 0 0 0 0 0 0 0 0
Must convert to 01100101 01101110 01100111 01101100 01101001 01110011 01101000