20 15 0 0
0 0 0 0 0 0 0 0 0 0 0 0 0 0 0 0 0 0 0 1
1 F 0 1 0 0 1 T T 1 F 0 1 F 0 1 0 0 0 1
1 0 0 1 0 0 1 F F 1 F 0 1 0 0 1 0 0 0 1
1 F F 1 0 0 1 F 0 1 F 0 1 0 F 1 F 0 0 1
1 T T 1 0 F 1 0 F 1 F 0 1 0 F 1 T 0 0 1
1 T T 1 F 0 1 T F 1 F 0 1 0 0 1 0 0 F 1
1 F F 1 0 T 1 F 0 1 F 0 1 F F 1 0 0 0 1
1 T 0 1 T 0 1 T 0 1 0 F 1 F F 1 0 0 0 1
1 0 0 1 F 0 1 F F 1 0 F 1 T T 1 F F F 1
1 0 0 1 0 0 1 0 F 1 0 F 1 F 0 1 0 0 0 1
1 0 T 1 0 F 1 0 F 1 0 T 1 0 0 1 0 T 0 1
1 0 0 1 T 0 1 0 F 1 0 0 1 F 0 1 0 0 0 1
1 0 T F 0 0 F 0 0 F 0 0 0 0 0 0 0 0 0 E
1 0 T F 0 0 0 0 0 F 0 0 0 0 0 0 0 0 0 E
1 1 1 1 1 1 1 1 1 1 1 1 1 1 1 1 1 1 1 1
01010011 t 01101111 01110000 00100000 g 01101111 01101001 n 01100111